6
B.P.B.G.B.P
-.B.-.S.-.B
B.-.S.W.S.-
P.B.-.S.B.-
B.-.-.B.P.B
-.-.-.-.B.-